Instituto/Curso, Canc.por Reopção, Decurso de Prazo Máximo P/ Conclusão de Curso, Desistência, Prescrito, Transferência para outra IES, Transferência Interna (administrativa), Total geral
C T
Instituto Amazônico de Agriculturas Familiares - INEAF, 1, 0, 12, 0, 0, 0, 13
Desenvolvimento Rural (Bacharelado), 1, 0, 12, 0, 0, 0, 13
Instituto de Ciências Biológicas - ICB, 4, 0, 33, 0, 0, 0, 37
Biomedicina (Bacharelado), 1, 0, 5, 0, 0, 0, 6
Biotecnologia (Bacharelado), 2, 0, 8, 0, 0, 0, 10
Ciências Biológicas (Bacharelado), 1, 0, 5, 0, 0, 0, 6
Ciências Biológicas (Licenciatura), 0, 0, 10, 0, 0, 0, 10
Engenharia de Bioprocessos (Bacharelado), 0, 0, 5, 0, 0, 0, 5
Instituto de Ciências da Arte - ICA, 10, 0, 18, 0, 0, 0, 28
Artes Visuais (Bacharelado), 0, 0, 1, 0, 0, 0, 1
Artes Visuais (Licenciatura), 3, 0, 4, 0, 0, 0, 7
Cinema e Audiovisual (Bacharelado), 1, 0, 2, 0, 0, 0, 3
Museologia (Bacharelado), 1, 0, 1, 0, 0, 0, 2
Teatro (Licenciatura), 2, 0, 4, 0, 0, 0, 6
Pedagogia (Licenciatura), 0, 0, 15, 0, 1, 0, 16
Enfermagem (Bacharelado), 2, 0, 9, 0, 0, 0, 11
Farmácia (Bacharelado), 0, 0, 14, 0, 0, 0, 14
Fisioterapia (Bacharelado), 0, 0, 8, 0, 0, 0, 8
Medicina (Bacharelado), 0, 0, 5, 0, 0, 1, 6
Odontologia (Bacharelado), 3, 0, 10, 0, 0, 0, 13
Terapia Ocupacional (Bacharelado), 1, 0, 6, 0, 0, 0, 7
Instituto de Ciências Exatas e Naturais - ICEN, 16, 0, 107, 0, 0, 0, 123
Ciências Naturais (Licenciatura), 1, 0, 17, 0, 0, 0, 18
Estatística (Bacharelado), 0, 0, 8, 0, 0, 0, 8
Física (Licenciatura), 0, 0, 5, 0, 0, 0, 5
Física (Bacharelado), 1, 0, 8, 0, 0, 0, 9
Física (Licenciatura), 5, 0, 22, 0, 0, 0, 27
Matemática (Licenciatura), 2, 0, 20, 0, 0, 0, 22
Química (Bacharelado), 2, 0, 2, 0, 0, 0, 4
Química (Licenciatura), 0, 0, 9, 0, 0, 0, 9
Química Industrial (Bacharelado), 3, 0, 8, 0, 0, 0, 11
Instituto de Ciências Jurídicas - ICJ, 0, 0, 11, 0, 2, 0, 13
Direito (Bacharelado), 0, 0, 11, 0, 2, 0, 13
Instituto de Ciências Sociais Aplicadas - ICSA, 16, 0, 108, 0, 0, 1, 125
Arquivologia (Bacharelado), 2, 0, 4, 0, 0, 0, 6
Biblioteconomia (Bacharelado), 1, 0, 13, 0, 0, 0, 14
Ciências Contábeis (Bacharelado), 1, 0, 14, 0, 0, 0, 15
Ciências Contábeis (Bacharelado) - Intensivo, 0, 0, 0, 0, 0, 1, 1
Economia (Bacharelado), 0, 0, 22, 0, 0, 0, 22
Turismo (Bacharelado), 5, 0, 20, 0, 0, 0, 25
Licenciatura Integrada em Ciências Matemática e Linguagens, 0, 0, 3, 0, 0, 0, 3
Instituto de Filosofia e Ciências Humanas - IFCH, 12, 6, 55, 1, 0, 0, 74
Ciências Sociais (Licenciatura), 0, 0, 4, 1, 0, 0, 5
Ciências Sociais (Bacharelado), 2, 0, 7, 0, 0, 0, 9
Ciências Sociais (Licenciatura), 1, 1, 6, 0, 0, 0, 8
Filosofia (Licenciatura), 0, 0, 2, 0, 0, 0, 2
Filosofia (Bacharelado), 2, 0, 1, 0, 0, 0, 3
Filosofia (Licenciatura), 2, 0, 9, 0, 0, 0, 11
Geografia (Bacharelado), 1, 0, 4, 0, 0, 0, 5
Geografia (Licenciatura), 1, 0, 4, 0, 0, 0, 5
História (Bacharelado), 1, 0, 6, 0, 0, 0, 7
História (Licenciatura), 1, 5, 6, 0, 0, 0, 12
História Mosqueiro (Licenciatura), 0, 0, 2, 0, 0, 0, 2
Instituto de Geociências - IG, 12, 1, 40, 0, 0, 0, 53
Geofísica (Bacharelado), 4, 0, 15, 0, 0, 0, 19
Geologia (Bacharelado), 3, 0, 9, 0, 0, 0, 12
Meteorologia (Bacharelado), 4, 1, 11, 0, 0, 0, 16
Oceanografia (Bacharelado), 1, 0, 5, 0, 0, 0, 6
Letras - Espanhol (Licenciatura), 1, 0, 3, 0, 0, 0, 4
Letras - Francês (Licenciatura), 3, 0, 2, 0, 0, 0, 5
Letras - Inglês (Licenciatura), 5, 0, 6, 0, 0, 0, 11
Letras - Libras - Intensivo (Licenciatura), 1, 0, 2, 0, 0, 0, 3
Letras - Língua Portuguesa (Licenciatura), 3, 0, 19, 0, 0, 0, 22
Instituto de Tecnologia - ITEC, 23, 0, 129, 0, 2, 0, 154
Arquitetura e Urbanismo (Bacharelado), 2, 0, 4, 0, 0, 0, 6
Engenharia Biomédica (Bacharelado), 3, 0, 7, 0, 0, 0, 10
Engenharia Civil (Bacharelado), 1, 0, 21, 0, 1, 0, 23
Engenharia de Alimentos (Bacharelado), 3, 0, 5, 0, 0, 0, 8
Engenharia Elétrica (Bacharelado), 0, 0, 13, 0, 0, 0, 13
Engenharia Ferroviária e Logística (Bacharelado), 2, 0, 3, 0, 0, 0, 5
Engenharia Naval (Bacharelado), 0, 0, 3, 0, 1, 0, 4
Engenharia Química (Bacharelado), 3, 0, 12, 0, 0, 0, 15
Engenharia Sanitária e Ambiental (Bacharelado), 2, 0, 15, 0, 0, 0, 17
Total geral, 119, 7, 645, 1, 5, 2, 779
